Normal
+-+-+-+-+-+-+-+-+-+-+-+-+
|                       |
+ @ @ @ @ @ @ @ @ @ @ @ +
|                       |
+ @ @ @ @ @ @ @ @ @ @ @ +
|                       |
+ @ @ @ @ @ @ @ @ @ @ @ +
|                       |
+ @ @ @ @ @ @ @ @ @ @ @ +
|                       |
+ @ @ @ @ @ @ @ @ @ @ @ +
|                       |
+ @ @ @ @ @ @ @ @ @ @ @ +
|                       |
+ @ @ @ @ @ @ @ @ @ @ @ +
|                       |
+ @ @ @ @ @ @ @ @ @ @ @ +
|                       |
+ @ @ @ @ @ @ @ @ @ @ @ +
|                       |
+-+-+-+-+-+-+-+-+-+-+-+-+
