Normal
+-+-+-+-+-+-+-+-+-+-+-+-+
| # # # # # # # # # # # |
+#+#+#+#+#+#+#+#+#+#+#+#+
| # # # # # # # # # # # |
+#+#+#+#+#+#+#+#+#+#+#+#+
| # # # # # # # # # # # |
+#+#+#+#+#+#+#+#+#+#+#+#+
| # # # # # # # # # # # |
+#+#+#+#+#+#+#+#+#+#+#+#+
| # # # # # # # # # # # |
+#+#+#+#+#+#+#+#+#+#+#+#+
| # # # # # # # # # # # |
+#+#+#+#+#+#+#+#+#+#+#+#+
| # # # # # # # # # # # |
+#+#+#+#+#+#+#+#+#+#+#+#+
| # # # # # # # # # # # |
+#+#+#+#+#+#+#+#+#+#+#+#+
| # # # # # # # # # # # |
+#+#+#+#+#+#+#+#+#+#+#+#+
| # # # # # # # # # # # |
+-+-+-+-+-+-+-+-+-+-+-+-+
