LD54
+-+-+-+-+-+-+-+-+-+-+-+-+
|                       |
+ + + + + + + + +-+-+-+ +
| | | | | | | | |     | |
+ + + + +-+ + + + + + + +
| | | | |   | | | | | | |
+ +-+ + + + + + + + + + +
|   |   |   |   | | | | |
+-+-+-+-+-+-+-+-+-+-+ + +
|     | |   |       |   |
+ + +-+ +-+ + +-+ + + + +
|   |   |   | | |   |   |
+ + + + + + + + + +-+ + +
|       |   | |         |
+ + +-+-+-+-+ +-+-+-+-+ +
|   |         | | |     |
+ + + +-+-+-+ +-+ + + + +
|   |     | |     |     |
+ + +-+-+ + +-+-+ + + + +
|               | |     |
+-+-+-+-+-+-+-+-+-+-+-+-+
