LD54
+-+-+-+-+-+-+-+-+-+-+-+-+
|                       |
+ + + + + + + + +-+-+-+ +
|*| |*|*| |*|*|*|* * *| |
+ + + + +-+ + + + + + + +
|*| |*|*|* *|*|*|*|*|*| |
+ +-+ + + + + + + + + + +
|* *|* *|* *|* *|*|*|*| |
+-+-+-+-+-+-+-+-+-+-+ + +
|     |*|* *|* * * *|   |
+ + +-+ +-+ + +-+ + + + +
|   |* *|* *|*| |* *|   |
+ + + + + + + + + +-+ + +
|    * *|* *|*|  * *    |
+ + +-+-+-+-+ +-+-+-+-+ +
|   |* * *   *| |*|     |
+ + + +-+-+-+ +-+ + + + +
|   |* * *| |* * *|     |
+ + +-+-+ + +-+-+ + + + +
|    * * *      |*|     |
+-+-+-+-+-+-+-+-+-+-+-+-+
