Big rooms
+-+-+-+-+-+-+-+-+-+-+-+-+
|     #     #     #     |
+ + + + + + + + + + + + +
|     #     #     #     |
+-+#+-+-+#+-+-+#+-+-+#+-+
|     #     #     #     |
+ + + + + + + + + + + + +
|     #     #     #     |
+-+#+-+-+#+-+-+#+-+-+#+-+
|     #     #     #     |
+ + + + + + + + + + + + +
|     #     #     #     |
+-+#+-+-+#+-+-+#+-+-+#+-+
|     #     #     #     |
+ + + + + + + + + + + + +
|     #     #     #     |
+-+#+-+-+#+-+-+#+-+-+#+-+
|     #     #     #     |
+ + + + + + + + + + + + +
|     #     #     #     |
+-+#+-+-+#+-+-+#+-+-+#+-+
