Shelves
+-+-+-+-+-+-+-+-+-+-+-+-+
|                       |
+#+#+#+#+#+#+#+#+#+#+#+#+
|                       |
+#+#+#+#+#+#+#+#+#+#+#+#+
|                       |
+#+#+#+#+#+#+#+#+#+#+#+#+
|                       |
+#+#+#+#+#+#+#+#+#+#+#+#+
|                       |
+#+#+#+#+#+#+#+#+#+#+#+#+
|                       |
+#+#+#+#+#+#+#+#+#+#+#+#+
|                       |
+#+#+#+#+#+#+#+#+#+#+#+#+
|                       |
+#+#+#+#+#+#+#+#+#+#+#+#+
|                       |
+#+#+#+#+#+#+#+#+#+#+#+#+
|                       |
+#+#+#+#+#+#+#+#+#+#+#+#+
|                       |
+-+-+-+-+-+-+-+-+-+-+-+-+
