Shelves
+-+-+-+-+-+-+-+-+-+-+-+-+
|                       |
+-+#+-+#+-+#+-+#+-+#+-+-+
|                       |
+-+-+-+-+-+-+-+-+-+-+-+-+
|                       |
+#+-+#+-+#+-+#+-+#+-+#+-+
|                       |
+-+-+-+-+-+-+-+-+-+-+-+-+
|                       |
+-+#+-+#+-+#+-+#+-+#+-+-+
|                       |
+-+-+-+-+-+-+-+-+-+-+-+-+
|                       |
+#+-+#+-+#+-+#+-+#+-+#+-+
|                       |
+-+-+-+-+-+-+-+-+-+-+-+-+
|                       |
+-+#+-+#+-+#+-+#+-+#+-+-+
|                       |
+-+-+-+-+-+-+-+-+-+-+-+-+
|                       |
+-+-+-+-+-+-+-+-+-+-+-+-+
