Onion
+-+-+-+-+-+-+-+-+-+-+-+-+
|           #           |
+ +#+#+#+#+#+#+#+#+#+#+ +
| #       #   #       # |
+ + +-+-+-+-+-+-+-+-+ + +
| # |               | # |
+#+ + +#+#+#+#+#+#+ + +#+
| # | #     #     # | # |
+ + + + +-+-+-+-+ + + + +
| # | # |       | # | # |
+ + + + + +-+-+ + + + + +
| # | # |       | # | # |
+ + + + +-+-+-+-+ + + + +
| # | #     #     # | # |
+#+ + +#+#+#+#+#+#+ + +#+
| # |               | # |
+ + +-+-+-+-+-+-+-+-+ + +
| #       #   #       # |
+ +#+#+#+#+#+#+#+#+#+#+ +
|           #           |
+-+-+-+-+-+-+-+-+-+-+-+-+
