Onion
+-+-+-+-+-+-+-+-+-+-+-+-+
|           #           |
+ +-+-+#+-+-+-+-+#+-+-+ +
| |                   | |
+ + +-+-+-+-+#+-+-+-+ + +
| | #               | | |
+#+ + +-+#+-+-+-+-+ + +#+
| | | |           | | | |
+ + + + +-+-+-+-+ + + + +
| # | # |       | | | # |
+ + + + + +-+-+ + + + + +
| # | | |       | # | # |
+ + + + +-+-+-+-+ + + + +
| | | |           | | | |
+#+ + +-+-+-+-+#+-+ + +#+
| | |               # | |
+ + +-+-+-+#+-+-+-+-+ + +
| |                   | |
+ +-+-+#+-+-+-+-+#+-+-+ +
|           #           |
+-+-+-+-+-+-+-+-+-+-+-+-+
