Pillars
+-+-+-+-+-+-+-+-+-+-+-+-+
|* * *|     |     |* * *|
+-+ +-+-+ +-+-+ +-+-+ +-+
| |*|   | |   | |   |*| |
+ + + + + + + + + + + + +
| |*|   | |   | |   |*| |
+ + + + + + + + + + + + +
| |*|   | |   | |   |*| |
+ + + + + + + + + + + + +
| |*|   | |   | |   |*| |
+ + + + + + + + + + + + +
| |*|   | |   | |   |*| |
+ + + + + + + + + + + + +
| |*|   | |   | |   |*| |
+ + + + + + + + + + + + +
| |*|   | |   | |   |*| |
+ + + + + + + + + + + + +
| |*|   | |   | |   |*| |
+-+ +-+-+ +-+-+ +-+-+ +-+
|* * *|     |     |* * *|
+-+-+-+-+-+-+-+-+-+-+-+-+
