Pillars
+-+-+-+-+-+-+-+-+-+-+-+-+
|     |     |     |     |
+-+ +-+-+ +-+-+ +-+-+ +-+
| | |   | |   | |   | | |
+ + + + + + + + + + + + +
| | |   | |   | |   | | |
+ + + + + + + + + + + + +
| | |   | |   | |   | | |
+ + + + + + + + + + + + +
| | |   | |   | |   | | |
+ + + + + + + + + + + + +
| | |   | |   | |   | | |
+ + + + + + + + + + + + +
| | |   | |   | |   | | |
+ + + + + + + + + + + + +
| | |   | |   | |   | | |
+ + + + + + + + + + + + +
| | |   | |   | |   | | |
+-+ +-+-+ +-+-+ +-+-+ +-+
|     |     |     |     |
+-+-+-+-+-+-+-+-+-+-+-+-+
