Onion
+-+-+-+-+-+-+-+-+-+-+-+-+
|                       |
+ +-+-+-+-+-+-+-+-+-+-+ +
| |                   | |
+ + +-+-+-+-+-+-+-+-+ + +
| | |               | | |
+ + + +-+-+-+-+-+-+ + + +
| | | |           | | | |
+ + + + +-+-+-+-+ + + + +
| | | | |       | | | | |
+ + + + + +-+-+ + + + + +
| | | | |       | | | | |
+ + + + +-+-+-+-+ + + + +
| | | |           | | | |
+ + + +-+-+-+-+-+-+ + + +
| | |               | | |
+ + +-+-+-+-+-+-+-+-+ + +
| |                   | |
+ +-+-+-+-+-+-+-+-+-+-+ +
|                       |
+-+-+-+-+-+-+-+-+-+-+-+-+
