Onion
+-+-+-+-+-+-+-+-+-+-+-+-+
|* * * * * * * * * * * *|
+ +-+-+-+-+-+-+-+-+-+-+ +
|*|                   |*|
+ + +-+-+-+-+-+-+-+-+ + +
|*| |* * * * * * * *| |*|
+ + + +-+-+-+-+-+-+ + + +
|*| |*|           |*| |*|
+ + + + +-+-+-+-+ + + + +
|*| |*| |* * * *| |*| |*|
+ + + + + +-+-+ + + + + +
|*| |*| |* * * *| |*| |*|
+ + + + +-+-+-+-+ + + + +
|*| |*|           |*| |*|
+ + + +-+-+-+-+-+-+ + + +
|*| |* * * * * * * *| |*|
+ + +-+-+-+-+-+-+-+-+ + +
|*|                   |*|
+ +-+-+-+-+-+-+-+-+-+-+ +
|* * * * * * * * * * * *|
+-+-+-+-+-+-+-+-+-+-+-+-+
