No maze
+-+-+-+-+-+-+-+-+-+-+-+-+
|                       |
+ + + + + + + + + + + + +
|                       |
+ + + + + + + + + + + + +
|                       |
+ + + + + + + + + + + + +
|                       |
+ + + + + + + + + + + + +
|                       |
+ + + + + + + + + + + + +
|                       |
+ + + + + + + + + + + + +
|                       |
+ + + + + + + + + + + + +
|                       |
+ + + + + + + + + + + + +
|                       |
+ + + + + + + + + + + + +
|                       |
+-+-+-+-+-+-+-+-+-+-+-+-+
