Miro
+-+-+-+-+-+-+-+-+-+-+-+-+
|                       |
+ + +-+-+-+-+-+-+ + + + +
|   |           |   |   |
+ + + + + + + + + + + + +
|   |           |   |   |
+ + + + + + + + + + + + +
|   |           |   |   |
+ + + + + + + + + + + + +
|   |           |   |   |
+ + +-+-+-+-+-+-+ + + + +
|                       |
+ +-+-+-+-+-+-+-+-+-+-+ +
|                     | |
+ +-+-+-+-+-+-+-+-+-+-+ +
| |                     |
+ +-+-+-+-+-+-+-+-+-+-+ +
|           |           |
+ +-+-+-+-+-+-+-+-+-+-+ +
|                       |
+-+-+-+-+-+-+-+-+-+-+-+-+
