Pillars
+-+-+-+-+-+-+-+-+-+-+-+-+
|     #     #     #     |
+-+ +-+-+ +-+-+ +-+-+ +-+
| | |   | |   | |   | | |
+ + + + + + + + + + + + +
| | |   | |   | |   | | |
+ + + + + + + + + + + + +
| # |   # #   # #   | # |
+ + + + + + + + + + + + +
| | |   | |   | |   | | |
+ + + + + + + + + + + + +
| | |   | |   | |   | | |
+ + + + + + + + + + + + +
| # |   # #   # #   | # |
+ + + + + + + + + + + + +
| | |   | |   | |   | | |
+ + + + + + + + + + + + +
| | |   | |   | |   | | |
+-+ +-+-+ +-+-+ +-+-+ +-+
|     #     #     #     |
+-+-+-+-+-+-+-+-+-+-+-+-+
