Shelves
+-+-+-+-+-+-+-+-+-+-+-+-+
|                       |
+-+-+#+-+-+-+-+-+-+#+-+-+
|                       |
+-+-+-+-+-+#+-+-+-+-+-+-+
|                       |
+-+-+#+-+-+-+-+-+-+#+-+-+
|                       |
+-+-+-+-+-+-+#+-+-+-+-+-+
|                       |
+-+-+#+-+-+-+-+-+-+#+-+-+
|                       |
+-+-+-+-+-+#+-+-+-+-+-+-+
|                       |
+-+-+#+-+-+-+-+-+-+#+-+-+
|                       |
+-+-+-+-+-+-+#+-+-+-+-+-+
|                       |
+-+-+#+-+-+-+-+-+-+#+-+-+
|                       |
+-+-+-+-+-+#+-+-+-+-+-+-+
|                       |
+-+-+-+-+-+-+-+-+-+-+-+-+
